                     
                    
         #           
         #           
         #           
         ########      
         #      #             $    
         #      #             #   
         #      #             #   
         #      ###############             
         ##           #            
         ###########       
            
               
