                     
                    
         #             
         #            
         #                          
         ########                 #####    ### 
         #      #             $   #   #   ## # 
         #      #             #   #   #####  # 
         #      #             #   ##         #  
         #      #####################        #       
         ##           #                      # ##$  
         ###########       ###### ########   ###                
                   #########    ###               
                                                      